0x1E 0x01
0x30 0x02
0x2E 0x03
0x20 0x04
0x12 0x05
0x21 0x06
0x22 0x07
0x23 0x08
0x17 0x09
0x24 0x0A
0x25 0x0B
0x26 0x0C
0x32 0x0D
0x31 0x0E
0x18 0x0F
0x19 0x10
0x10 0x11
0x13 0x12
0x1F 0x13
0x14 0x14
0x16 0x15
0x2F 0x16
0x11 0x17
0x2D 0x18
0x15 0x19
0x2C 0x1A
0x02 0x11
0x03 0x00
0x04 0x13
0x05 0x14
0x06 0x15
0x07 0x1E
0x08 0x17
0x09 0x18
0x0A 0x19
0x0B 0x10
0x0C 0x1F
0x0D 0x1D
0x29 0x00
0x2B 0x1C
0x1A 0x1B
0x1B 0x1D
0x27 0x1B
0x28 0x07
0x33 0x0C
0x34 0x0E
0x35 0x0F
0x39 0x00
0x01 0x1B
0x0E 0x08
0x53 0x1F
0x1C 0x0A
0x0F 0x09
0x62 0x00
0x61 0x00
0x52 0x00
0x77 0x00
0x48 0x00
0x50 0x00
0x73 0x00
0x74 0x00
0x63 0x08
0x64 0x09
0x65 0xOF
0x66 0x0A
0x4A 0x1F
0x4E 0xOB
0x71 0x0E
0x72 0x0A
0x70 0x10
0x6D 0x11
0x6E 0x00
0x6F 0x13
0x6A 0x14
0x6B 0x15
0x6C 0x1E
0x67 0x17
0x68 0x18
0x69 0x19
0x3B 0x00
0x3C 0x00
0x3D 0x00
0x3E 0x00
0x3F 0x00
0x40 0x00
0x41 0x00
0x42 0x00
0x43 0x00
0x44 0x00