0x01 0x1B
0x0E 0x08
0x0F 0x09
0x10 0x00
0x11 0x00
0x12 0x00
0x13 0x00
0x14 0x00
0x15 0x00
0x16 0x00
0x17 0x00 
0x18 0x00
0x19 0x00
0x1A 0x5B
0x1B 0x5D
0x1C 0x0D
0x1E 0x00
0x1F 0x00
0x20 0x00
0x21 0x00
0x22 0x00
0x23 0x00
0x24 0x00
0x25 0x00
0x26 0x00
0x27 0x3B
0x28 0x27
0x29 0x60
0x2B 0x5C
0x2C 0x00
0x2D 0x00
0x2E 0x00
0x2F 0x00
0x30 0x00
0x31 0x00
0x32 0x00
0x33 0x2C
0x34 0x2E
0x35 0x2F
0x39 0x20
0x3B 0x00
0x3C 0x00
0x3D 0x00
0x3E 0x00
0x3F 0x00
0x40 0x00
0x41 0x00
0x42 0x00
0x43 0x00
0x44 0x00
0x4A 0x2D
0x4E 0x2B
0x53 0x7F
0x61 0x00
0x63 0x28
0x64 0x29
0x65 0x2F
0x66 0x2A
0x67 0x37
0x68 0x38
0x69 0x39
0x6A 0x34
0x6B 0x35
0x6C 0x36
0x6D 0x31
0x6E 0x32
0x6F 0x33
0x70 0x30
0x71 0x2E
0x72 0x0D
0x78 0x00
0x79 0x00
0x7A 0x00
0x7B 0x00
0x7C 0x00
0x7D 0x00
0x7E 0x00
0x7F 0x00
0x80 0x00
0x81 0x00
0x82 0x00
0x83 0x00
